R  1000 800

S ./textures/barrel.xpm

NO ./textures/redstone.xpm
SO ./textures/bluestone.xpm
EA ./textures/purplestone.xpm
WE ./textures/eagle.xpm 



C ./textures/skybox.xpm
F ./textures/greystone.xpm

11111111111111111111111111111111111
11111111111111111111111111111111111

11111111111111111111111111111111111

11111111111111111111111111111111111
10000000000020000000000000011111111
10000000000000000000000000000111111
10000000000000000000000000000111111
11111111111100011111111111111111101
12000001200000000000000000000000001
10000010000000000000000000000000001
10000000000000002000000000000111101
10000000000000000000000000000111111
100000010000000000000N0000000111111
12000001200000000000000000002111111
11111111110111111111111111111111111
11111111111111111111111111111111111